NO ./textures/wolfenstein/purple_stone.xpm
SO ./textures/wolfenstein/red_brick.xpm
WE ./textures/wolfenstein/grey_stone.xpm
EA textures/wolfenstein/wood.xpm

C 218, 234, 255
F 17, 38, 64

1111111111111111111111111
1000110000100000000000001
1000110000001111110000001
1000110010000000110001001
10001000001000000000010N1
1111111111111111111111111
